               
SO ./mandatory/textures/all.png
                  WE                           ./mandatory/textures/all.png

  NO ./mandatory/textures/all.png
EA                              ./mandatory/textures/all.png
F                       220,100,0
                                           C                         250,30,0



111111
1000001
1110001
11111N01
1111111
