               
SO ./bonus/textures/all.png
                  WE                           ./bonus/textures/all.png

  NO ./bonus/textures/all.png
EA                              ./bonus/textures/all.png
F                       220,100,0
                                           C                         250,30,0




11111111111 11111111111111
10000000001 10000000000001
10110000011 10000000000001
10010000001 10000N00000001
11111111101 10000000000001
10000000001 10111011111111
11111111111 11111111111111
1
11111111111111111111111111
10000000001100000000000011
10110000011100000000000011
10010000001000000000000011
11111111101100000000000011
10000000001100101011111111
111111111111111 1111111111
