               
SO ./bonus/textures/all.png
                  WE                           ./bonus/textures/all.png

  NO ./bonus/textures/all.png
EA                              ./bonus/textures/all.png
F                       220,100,0
                                           C                         250,30,0



 11111 
1000001
 110001
   1N01
    11 
