               
SO ./mandatory/textures/all.png
                  WE                           ./mandatory/textures/all.png

  NO ./mandatory/textures/all.png
EA                              ./mandatory/textures/all.png
F                       220,100,0
                                           C                         250,30,0



 11111 
1000001
 110001
   0N01
    11 
