               
SO ./textures/south.png
                  WE                           ./textures/west.png

  NO ./textures/north.png

EA                              ./textures/east.png
F 80,250,50
                                           C     						250,30,50




1111111111111111111111111
1000000000110000000000001
1011000001110000000000001
10010000000000000010000011111111
111111111011000001110000000000001
100000000011000001110111111100001
1111111111111101110000000000100011111111111111111111111
1            1111001111111101000000000000000000000000001
1111111111111101110000000000110000000000000000000000111111111111
10000000000000000000000000001000000001000000000000000000000000001
10000000000000001101010010000100000001000000000000000000000000001
11110111 1110101 101111010000000000001000000000000000000000000001
11110111 1110101 101111010000000000001000000000000000000000000001
11110111 1110101 101111010000000000001000000000000000000000000001
11110111 1110101 101111010000000000001000000000000000000000000001
11110111 1110101 1011110100000000000011111111100000000000000000001
1100000111010101111101111000000000000000000000000000000000000000111
11110111 1110101 101111010000000000000000000000001111111111100111
11110111 1110101 10111101000000000000000000S00000000000000000001
11110111 1110101 1011110100000000000000000000000000000000000011111
11110111 1110101 101111010000000000000000000000000000000000000001
11110111 1110101 101111010000000000000000000000000000000000000001
11110111 1110101 101111010000000010000000000000000000000000000001
11110111 1110101 101111010000000010000000000000000000000000000001
11111111111111111111111111111111111111111111111111111111111111111
