               
SO ./textures/all.png
                  WE                           ./textures/all.png

  NO ./textures/all.png

EA                              ./textures/all.png
F 220,100,0
                                           C     						250,30,0


1000000000110000000000001
1011000001110000000000001
10010000000000000000000011111111
111111111011000001110000000000001
100000000011000001110111111111111
111111111111110111000000000011111111111111
             11110011111111011101010010001
11111111111111011100000010001111111111111111111111111111111111111
10000000000000000000000010001000000001000000000000000000000000001
10000000000000001101010010000100000001000000000000000000000000001
11110111 1110101 101111010000000000001000000000000000000000000001
11110111 1110101 101111010000000000001000000000000000000000000001
11110111 1110101 101111010000000000001000000000000000000000000001
11110111 1110101 101111010000000000001000000000000000000000000001
11110111 1110101 1011110100000000000011111111100000000000000000001
1100000111010101111101111000000000000000000000000000000000000000111
11110111 1110101 101111010000000000000000000000001111111111100001
11110111 1110101 10111101111111000000000000N0001000000000000001
11110111 1110101 1011110100000000000000000000000000000000000011111
11110111 1110101 101111010000000010000000011111111000000000000001
11110111 1110101 101111010000000010000000000000000000000000000001
11110111 1110101 101111010000000010000000000000000000000000000001
11110111 1110101 101111010000000010000000000000000000000000000001
11111111 1111111 111111111111111111111111111111111111111111111111
